NO ./xpm/north.xpm
SO ./xpm/south.xpm
WE ./xpm/west.xpm
EA ./xpm/east.xpm
F 0,0,0
C 0,0,0 
        1111111111111111111111111
        1000000000110000000000001
        1011000001110000000000001
        1001000000000000000000001
111111111011000001110000000000001
100000000011000001110111111111111
11110111111111011101010010001
11000000110101011100000010001
1000000000000000100000010001
1101111111110111100000000N001
10000000000000001101010010001
110000011101010111110111100111
1111011111101011011110100001
111111 1111111 11111 11111111